211111111111111111111111111111111111112
100000000000000000000000000000000000001
100000000000000000000000000000000000001
100000000000000000020000000000000000001
100000000000000000020000000000000000001
100000000000000000020000000000000000001
100000000000000000020000000000000000001
100000000000000000020000000000000000001
100000222222222222222222222222222000001
100000000000000000020000000000000000001
100000000000000000020000000000000000001
100000000000000000020000000000000000001
100000000000000000020000000000000000001
100000000000000000020000000000000000001
100000000000000000020000000000000000001
100000000000000000000000000000000000001
100000000000000000000000000000000000001
100000000000000000000000000000000000001
211111111111111111111111111111111111112 