211111111111111111121111111111111111112
100000000000000000010000000000000000001
100000000000000000010000000000000000001
100000000000000000010000000000000000001
100000000000000000010000000000000000001
100000000000000000010000000000000000001
100000000000000000010000000000000000001
100000000000000000010000000000000000001
100000000000000000010000000000000000001
211111111111111111121111111111111111112
10000000000000000001                             
10000000000000000001                               
10000000000000000001                                     
10000000000000000001                    
10000000000000000001                       
10000000000000000001                             
10000000000000000001                     
10000000000000000001                        
21111111111111111112                           